ID,REGION,PROVINCIA,COMUNA,NOM_REGION,NOM_PROVIN,NOM_COMUNA,TOTAL_VIVI,PARTICULAR,COLECTIVAS,TOTAL_PERS,HOMBRES,MUJERES,DENSIDAD,INDICE_MAS,INDICE_DEP,IND_DEP_JU,IND_DEP_VE
12,15,151,15101,REGIÓN DE ARICA Y PARINACOTA,ARICA,ARICA,72639,72414,225,221364,109389,111975,46.2,97.7,48.9,32.7,16.2
25,15,151,15102,REGIÓN DE ARICA Y PARINACOTA,ARICA,CAMARONES,948,927,21,1255,726,529,0.3,137.2,46.8,22.7,24.1
243,15,152,15201,REGIÓN DE ARICA Y PARINACOTA,PARINACOTA,PUTRE,1917,1875,42,2765,2054,711,0.5,288.9,21.3,11,10.3
99,15,152,15202,REGIÓN DE ARICA Y PARINACOTA,PARINACOTA,GENERAL LAGOS,697,686,11,684,412,272,0.3,151.5,41.9,21.4,20.5
113,1,11,1101,REGIÓN DE TARAPACÁ,IQUIQUE,IQUIQUE,66986,66725,261,191468,94897,96571,83.7,98.3,43.8,30.5,13.3
5,1,11,1107,REGIÓN DE TARAPACÁ,IQUIQUE,ALTO HOSPICIO,33178,33162,16,108375,54206,54169,188.9,100.1,48.3,42,6.3
226,1,14,1401,REGIÓN DE TARAPACÁ,TAMARUGAL,POZO ALMONTE,8926,8884,42,15711,8987,6724,1.1,133.7,43.3,33,10.3
26,1,14,1402,REGIÓN DE TARAPACÁ,TAMARUGAL,CAMIÑA,1092,1088,4,1250,657,593,0.6,110.8,60.5,35.3,25.2
58,1,14,1403,REGIÓN DE TARAPACÁ,TAMARUGAL,COLCHANE,2030,2025,5,1728,995,733,0.4,135.7,36.4,19.9,16.5
108,1,14,1404,REGIÓN DE TARAPACÁ,TAMARUGAL,HUARA,2871,2863,8,2730,1501,1229,0.3,122.1,58.5,36.1,22.5
217,1,14,1405,REGIÓN DE TARAPACÁ,TAMARUGAL,PICA,2726,2703,23,9296,6550,2746,1,238.5,25.1,15.7,9.5
9,2,21,2101,REGIÓN DE ANTOFAGASTA,ANTOFAGASTA,ANTOFAGASTA,112451,112275,176,361873,181846,180027,11.8,101,40.8,29.7,11.1
170,2,21,2102,REGIÓN DE ANTOFAGASTA,ANTOFAGASTA,MEJILLONES,4216,3976,240,13467,8035,5432,3.8,147.9,33.7,26.2,7.5
309,2,21,2103,REGIÓN DE ANTOFAGASTA,ANTOFAGASTA,SIERRA GORDA,570,527,43,10186,8662,1524,0.8,568.4,4.6,3.3,1.3
313,2,21,2104,REGIÓN DE ANTOFAGASTA,ANTOFAGASTA,TALTAL,4593,4548,45,13317,7481,5836,0.7,128.2,43.6,30.5,13.1
19,2,22,2201,REGIÓN DE ANTOFAGASTA,EL LOA,CALAMA,57307,56963,344,165731,86049,79682,10.6,108,40.8,31.4,9.4
189,2,22,2202,REGIÓN DE ANTOFAGASTA,EL LOA,OLLAGÜE,439,427,12,321,207,114,0.1,181.6,34.3,24.3,10
297,2,22,2203,REGIÓN DE ANTOFAGASTA,EL LOA,SAN PEDRO DE ATACAMA,4144,3972,172,10996,6161,4835,0.5,127.4,29.5,21.2,8.3
321,2,23,2301,REGIÓN DE ANTOFAGASTA,TOCOPILLA,TOCOPILLA,10670,10620,50,25186,12481,12705,6.2,98.2,52.8,36.6,16.2
165,2,23,2302,REGIÓN DE ANTOFAGASTA,TOCOPILLA,MARÍA ELENA,1959,1865,94,6457,4092,2365,0.5,173,25.2,19.4,5.8
68,3,31,3101,REGIÓN DE ATACAMA,COPIAPÓ,COPIAPÓ,55565,55453,112,153937,76627,77310,8.7,99.1,46.8,33.8,13
21,3,31,3102,REGIÓN DE ATACAMA,COPIAPÓ,CALDERA,15651,15612,39,17662,9094,8568,4.8,106.1,48.6,33.7,14.9
317,3,31,3103,REGIÓN DE ATACAMA,COPIAPÓ,TIERRA AMARILLA,4745,4705,40,14019,7796,6223,1.2,125.3,43.1,32.2,10.9
39,3,32,3201,REGIÓN DE ATACAMA,CHAÑARAL,CHAÑARAL,6153,6122,31,12219,6270,5949,2.1,105.4,54.2,37.2,17
81,3,32,3202,REGIÓN DE ATACAMA,CHAÑARAL,DIEGO DE ALMAGRO,6914,6812,102,13925,7486,6439,0.7,116.3,44.3,33.9,10.4
330,3,33,3301,REGIÓN DE ATACAMA,HUASCO,VALLENAR,19402,19339,63,51917,25422,26495,7.2,96,54.1,35.2,18.9
4,3,33,3302,REGIÓN DE ATACAMA,HUASCO,ALTO DEL CARMEN,2927,2903,24,5299,2925,2374,0.9,123.2,55.4,30,25.4
93,3,33,3303,REGIÓN DE ATACAMA,HUASCO,FREIRINA,3511,3498,13,7041,3557,3484,2.2,102.1,55.7,35.9,19.7
109,3,33,3304,REGIÓN DE ATACAMA,HUASCO,HUASCO,6226,6201,25,10149,5243,4906,6.3,106.9,51.7,33.6,18.1
126,4,41,4101,REGIÓN DE COQUIMBO,ELQUI,LA SERENA,87464,87267,197,221054,105836,115218,116.3,91.9,47.5,31.3,16.2
69,4,41,4102,REGIÓN DE COQUIMBO,ELQUI,COQUIMBO,89499,89339,160,227730,109872,117858,159.8,93.2,49.2,33.4,15.8
7,4,41,4103,REGIÓN DE COQUIMBO,ELQUI,ANDACOLLO,4506,4491,15,11044,5519,5525,21.5,99.9,55.8,34.6,21.2
122,4,41,4104,REGIÓN DE COQUIMBO,ELQUI,LA HIGUERA,2660,2643,17,4241,2236,2005,1,111.5,56.3,35.4,20.9
195,4,41,4105,REGIÓN DE COQUIMBO,ELQUI,PAIGUANO,2373,2348,25,4497,2240,2257,3,99.2,49.9,28.1,21.8
334,4,41,4106,REGIÓN DE COQUIMBO,ELQUI,VICUÑA,10779,10733,46,27771,13792,13979,3.7,98.7,52,33.2,18.8
111,4,42,4201,REGIÓN DE COQUIMBO,CHOAPA,ILLAPEL,12320,12285,35,30848,14739,16109,11.7,91.5,56,34.2,21.8
27,4,42,4202,REGIÓN DE COQUIMBO,CHOAPA,CANELA,5278,5270,8,9093,4632,4461,4.1,103.8,62,29.6,32.4
156,4,42,4203,REGIÓN DE COQUIMBO,CHOAPA,LOS VILOS,13288,13237,51,21382,11061,10321,11.5,107.2,51.5,31.7,19.7
278,4,42,4204,REGIÓN DE COQUIMBO,CHOAPA,SALAMANCA,10697,10612,85,29347,15712,13635,8.5,115.2,47.4,28.9,18.5
192,4,43,4301,REGIÓN DE COQUIMBO,LIMARÍ,OVALLE,42095,42039,56,111272,53619,57653,31.3,93,52.4,34.1,18.3
62,4,43,4302,REGIÓN DE COQUIMBO,LIMARÍ,COMBARBALÁ,6999,6980,19,13322,6656,6666,5.8,99.8,59.3,29.2,30.1
174,4,43,4303,REGIÓN DE COQUIMBO,LIMARÍ,MONTE PATRIA,13074,13043,31,30751,15270,15481,7.3,98.6,55,34.5,20.5
237,4,43,4304,REGIÓN DE COQUIMBO,LIMARÍ,PUNITAQUI,4812,4806,6,10956,5452,5504,10,99.1,60.3,36.4,23.9
271,4,43,4305,REGIÓN DE COQUIMBO,LIMARÍ,RÍO HURTADO,2764,2751,13,4278,2138,2140,1.9,99.9,59.6,28.1,31.4
331,5,51,5101,REGIÓN DE VALPARAÍSO,VALPARAÍSO,VALPARAÍSO,117196,116835,361,296655,144945,151710,935.3,95.5,45.2,25.8,19.4
31,5,51,5102,REGIÓN DE VALPARAÍSO,VALPARAÍSO,CASABLANCA,11606,11588,18,26867,13346,13521,28.1,98.7,47.5,29.6,17.9
63,5,51,5103,REGIÓN DE VALPARAÍSO,VALPARAÍSO,CONCÓN,20290,20266,24,42152,20321,21831,549.9,93.1,45.1,28.2,16.8
116,5,51,5104,REGIÓN DE VALPARAÍSO,VALPARAÍSO,JUAN FERNÁNDEZ,445,438,7,926,499,427,8.7,116.9,41.4,29.2,12.2
229,5,51,5105,REGIÓN DE VALPARAÍSO,VALPARAÍSO,PUCHUNCAVÍ,17451,17436,15,18546,9358,9188,61.7,101.9,52.2,30.3,21.9
257,5,51,5107,REGIÓN DE VALPARAÍSO,VALPARAÍSO,QUINTERO,17442,17417,25,31923,15834,16089,218.4,98.4,51.7,31.5,20.2
339,5,51,5109,REGIÓN DE VALPARAÍSO,VALPARAÍSO,VIÑA DEL MAR,147117,146844,273,334248,158669,175579,2772.2,90.4,45.7,24.1,21.6
115,5,52,5201,REGIÓN DE VALPARAÍSO,ISLA DE PASCUA,ISLA DE PASCUA,3136,3022,114,7750,3819,3931,31.5,97.2,37.6,29.1,8.4
151,5,53,5301,REGIÓN DE VALPARAÍSO,LOS ANDES,LOS ANDES,23661,23581,80,66708,33289,33419,54.1,99.6,46.9,29.2,17.7
24,5,53,5302,REGIÓN DE VALPARAÍSO,LOS ANDES,CALLE LARGA,5488,5484,4,14832,7328,7504,46,97.7,51.5,34.3,17.2
268,5,53,5303,REGIÓN DE VALPARAÍSO,LOS ANDES,RINCONADA,3634,3622,12,10207,5134,5073,82.9,101.2,51.7,35.1,16.6
283,5,53,5304,REGIÓN DE VALPARAÍSO,LOS ANDES,SAN ESTEBAN,7323,7317,6,18855,9303,9552,13.7,97.4,50.9,32.9,18
123,5,54,5401,REGIÓN DE VALPARAÍSO,PETORCA,LA LIGUA,17309,17285,24,35390,17340,18050,30.4,96.1,51,30.5,20.5
16,5,54,5402,REGIÓN DE VALPARAÍSO,PETORCA,CABILDO,7064,7052,12,19388,9467,9921,13.3,95.4,52.8,33.7,19.1
202,5,54,5403,REGIÓN DE VALPARAÍSO,PETORCA,PAPUDO,5823,5814,9,6356,3341,3015,38.1,110.8,42.4,24.8,17.6
215,5,54,5404,REGIÓN DE VALPARAÍSO,PETORCA,PETORCA,4446,4435,11,9826,4889,4937,6.5,99,51.7,29.1,22.6
344,5,54,5405,REGIÓN DE VALPARAÍSO,PETORCA,ZAPALLAR,6961,6954,7,7339,3704,3635,25.4,101.9,48.8,27,21.8
252,5,55,5501,REGIÓN DE VALPARAÍSO,QUILLOTA,QUILLOTA,33118,33068,50,90517,43537,46980,300.2,92.7,49.9,30,19.8
22,5,55,5502,REGIÓN DE VALPARAÍSO,QUILLOTA,CALERA,18106,18093,13,50554,24462,26092,852.4,93.8,50.7,31,19.7
103,5,55,5503,REGIÓN DE VALPARAÍSO,QUILLOTA,HIJUELAS,6596,6589,7,17988,9037,8951,66.9,101,48.1,30.6,17.5
118,5,55,5504,REGIÓN DE VALPARAÍSO,QUILLOTA,LA CRUZ,8064,8061,3,22098,10656,11442,282.8,93.1,49.7,34.2,15.4
183,5,55,5506,REGIÓN DE VALPARAÍSO,QUILLOTA,NOGALES,7690,7681,9,22120,10799,11321,54.6,95.4,52.2,32,20.1
279,5,56,5601,REGIÓN DE VALPARAÍSO,SAN ANTONIO,SAN ANTONIO,32493,32410,83,91350,44713,46637,229.2,95.9,49.6,30.6,19
1,5,56,5602,REGIÓN DE VALPARAÍSO,SAN ANTONIO,ALGARROBO,19956,19944,12,13817,6734,7083,78.7,95.1,58.4,27.8,30.6
30,5,56,5603,REGIÓN DE VALPARAÍSO,SAN ANTONIO,CARTAGENA,15778,15758,20,22738,11265,11473,93,98.2,58.4,32,26.4
86,5,56,5604,REGIÓN DE VALPARAÍSO,SAN ANTONIO,EL QUISCO,18312,18260,52,15955,7826,8129,315,96.3,63.6,29.3,34.3
87,5,56,5605,REGIÓN DE VALPARAÍSO,SAN ANTONIO,EL TABO,20596,20568,28,13286,6682,6604,134.2,101.2,61.3,27.8,33.5
308,5,56,5606,REGIÓN DE VALPARAÍSO,SAN ANTONIO,SANTO DOMINGO,7828,7820,8,10900,5428,5472,20.5,99.2,51.1,30.9,20.2
285,5,57,5701,REGIÓN DE VALPARAÍSO,SAN FELIPE DE ACONCAGUA,SAN FELIPE,27708,27672,36,76844,37219,39625,411.2,93.9,49.3,31.9,17.4
33,5,57,5702,REGIÓN DE VALPARAÍSO,SAN FELIPE DE ACONCAGUA,CATEMU,5171,5164,7,13998,6982,7016,38.8,99.5,52,31.8,20.2
142,5,57,5703,REGIÓN DE VALPARAÍSO,SAN FELIPE DE ACONCAGUA,LLAILLAY,8927,8913,14,24608,12216,12392,70.5,98.6,51.1,32.5,18.6
201,5,57,5704,REGIÓN DE VALPARAÍSO,SAN FELIPE DE ACONCAGUA,PANQUEHUE,2514,2509,5,7273,3677,3596,60.1,102.3,49.7,32.3,17.5
242,5,57,5705,REGIÓN DE VALPARAÍSO,SAN FELIPE DE ACONCAGUA,PUTAENDO,6337,6312,25,16754,8358,8396,11.5,99.5,53.2,30.4,22.8
306,5,57,5706,REGIÓN DE VALPARAÍSO,SAN FELIPE DE ACONCAGUA,SANTA MARÍA,5587,5584,3,15241,7586,7655,92,99.1,49.7,31,18.6
253,5,58,5801,REGIÓN DE VALPARAÍSO,MARGA MARGA,QUILPUÉ,56851,56819,32,151708,71746,79962,283,89.7,49.4,27.5,21.9
138,5,58,5802,REGIÓN DE VALPARAÍSO,MARGA MARGA,LIMACHE,16710,16683,27,46121,22353,23768,156.2,94,52.2,30.9,21.3
190,5,58,5803,REGIÓN DE VALPARAÍSO,MARGA MARGA,OLMUÉ,9090,9085,5,17516,8597,8919,75.7,96.4,53.6,29.3,24.3
337,5,58,5804,REGIÓN DE VALPARAÍSO,MARGA MARGA,VILLA ALEMANA,44982,44937,45,126548,59756,66792,1318,89.5,49.3,29.8,19.5
307,13,131,13101,REGIÓN METROPOLITANA DE SANTIAGO,SANTIAGO,SANTIAGO,193628,193263,365,404495,206678,197817,17485.2,104.5,24.4,15.2,9.2
35,13,131,13102,REGIÓN METROPOLITANA DE SANTIAGO,SANTIAGO,CERRILLOS,24547,24531,16,80832,39631,41201,4818.8,96.2,47,29.5,17.5
36,13,131,13103,REGIÓN METROPOLITANA DE SANTIAGO,SANTIAGO,CERRO NAVIA,38020,38016,4,132622,65438,67184,11949.6,97.4,47.4,29.2,18.2
65,13,131,13104,REGIÓN METROPOLITANA DE SANTIAGO,SANTIAGO,CONCHALÍ,37759,37735,24,126955,61877,65078,11427.9,95.1,47.8,27.5,20.3
83,13,131,13105,REGIÓN METROPOLITANA DE SANTIAGO,SANTIAGO,EL BOSQUE,47941,47892,49,162505,79372,83133,11344.6,95.5,48.2,30.1,18.1
90,13,131,13106,REGIÓN METROPOLITANA DE SANTIAGO,SANTIAGO,ESTACIÓN CENTRAL,52486,52413,73,147041,73458,73583,10244.4,99.8,39.2,22.7,16.5
110,13,131,13107,REGIÓN METROPOLITANA DE SANTIAGO,SANTIAGO,HUECHURABA,28945,28939,6,98671,48122,50549,2197.5,95.2,48.9,34.7,14.2
112,13,131,13108,REGIÓN METROPOLITANA DE SANTIAGO,SANTIAGO,INDEPENDENCIA,36666,36612,54,100281,49186,51095,13627.2,96.3,38.4,23.2,15.2
117,13,131,13109,REGIÓN METROPOLITANA DE SANTIAGO,SANTIAGO,LA CISTERNA,31480,31421,59,90119,43147,46972,9030.7,91.9,47.4,26.2,21.2
120,13,131,13110,REGIÓN METROPOLITANA DE SANTIAGO,SANTIAGO,LA FLORIDA,120035,119960,75,366916,175693,191223,5180.7,91.9,45.3,26.6,18.6
121,13,131,13111,REGIÓN METROPOLITANA DE SANTIAGO,SANTIAGO,LA GRANJA,34423,34403,20,116571,57025,59546,11553.6,95.8,45.5,28.2,17.4
124,13,131,13112,REGIÓN METROPOLITANA DE SANTIAGO,SANTIAGO,LA PINTANA,50042,50012,30,177335,87044,90291,5823.6,96.4,48.5,34.9,13.6
125,13,131,13113,REGIÓN METROPOLITANA DE SANTIAGO,SANTIAGO,LA REINA,29801,29732,69,92787,43599,49188,3958.8,88.6,48.7,26.5,22.2
134,13,131,13114,REGIÓN METROPOLITANA DE SANTIAGO,SANTIAGO,LAS CONDES,118007,117901,106,294838,135917,158921,2977,85.5,44.7,22.1,22.6
143,13,131,13115,REGIÓN METROPOLITANA DE SANTIAGO,SANTIAGO,LO BARNECHEA,31225,31195,30,105833,50500,55333,103.4,91.3,44.6,33.6,11
144,13,131,13116,REGIÓN METROPOLITANA DE SANTIAGO,SANTIAGO,LO ESPEJO,26774,26762,12,98804,49146,49658,11986.6,99,45.8,28.7,17.1
145,13,131,13117,REGIÓN METROPOLITANA DE SANTIAGO,SANTIAGO,LO PRADO,29526,29516,10,96249,46799,49450,14672.9,94.6,48.7,27,21.6
160,13,131,13118,REGIÓN METROPOLITANA DE SANTIAGO,SANTIAGO,MACUL,43121,43085,36,116534,55161,61373,9074.2,89.9,45.8,24.4,21.4
162,13,131,13119,REGIÓN METROPOLITANA DE SANTIAGO,SANTIAGO,MAIPÚ,161354,161301,53,521627,250792,270835,3788.7,92.6,40.3,27.1,13.2
186,13,131,13120,REGIÓN METROPOLITANA DE SANTIAGO,SANTIAGO,ÑUÑOA,92248,92121,127,208237,95409,112828,12353,84.6,41.8,21.1,20.7
205,13,131,13121,REGIÓN METROPOLITANA DE SANTIAGO,SANTIAGO,PEDRO AGUIRRE CERDA,29906,29890,16,101174,49513,51661,11553.8,95.8,47.2,26.3,20.9
212,13,131,13122,REGIÓN METROPOLITANA DE SANTIAGO,SANTIAGO,PEÑALOLÉN,70394,70376,18,241599,116882,124717,4506.9,93.7,44.2,29.3,14.9
228,13,131,13123,REGIÓN METROPOLITANA DE SANTIAGO,SANTIAGO,PROVIDENCIA,70965,70738,227,142079,65710,76369,9873.1,86,39.2,17.4,21.8
231,13,131,13124,REGIÓN METROPOLITANA DE SANTIAGO,SANTIAGO,PUDAHUEL,68940,68918,22,230293,112412,117881,1167.5,95.4,41.5,29.5,12
249,13,131,13125,REGIÓN METROPOLITANA DE SANTIAGO,SANTIAGO,QUILICURA,62470,62461,9,210410,103456,106954,3670.7,96.7,39.3,31.7,7.6
256,13,131,13126,REGIÓN METROPOLITANA DE SANTIAGO,SANTIAGO,QUINTA NORMAL,38989,38951,38,110026,53669,56357,9311.9,95.2,43.9,25.2,18.7
262,13,131,13127,REGIÓN METROPOLITANA DE SANTIAGO,SANTIAGO,RECOLETA,50178,50113,65,157851,77709,80142,10000.2,97,44,26,18.1
264,13,131,13128,REGIÓN METROPOLITANA DE SANTIAGO,SANTIAGO,RENCA,43174,43165,9,147151,72681,74470,6194.4,97.6,46.8,32.1,14.7
290,13,131,13129,REGIÓN METROPOLITANA DE SANTIAGO,SANTIAGO,SAN JOAQUÍN,30096,30071,25,94492,45831,48661,9504.2,94.2,47.1,25.3,21.8
293,13,131,13130,REGIÓN METROPOLITANA DE SANTIAGO,SANTIAGO,SAN MIGUEL,42947,42893,54,107954,50738,57216,11229.8,88.7,41.6,23.5,18.1
300,13,131,13131,REGIÓN METROPOLITANA DE SANTIAGO,SANTIAGO,SAN RAMÓN,23855,23843,12,82900,40873,42027,13207.6,97.3,50.8,28.8,22
340,13,131,13132,REGIÓN METROPOLITANA DE SANTIAGO,SANTIAGO,VITACURA,31777,31745,32,85384,38402,46982,3003.8,81.7,56.4,28.8,27.5
232,13,132,13201,REGIÓN METROPOLITANA DE SANTIAGO,CORDILLERA,PUENTE ALTO,171511,171450,61,568106,275147,292959,6439.5,93.9,41.4,30.6,10.8
221,13,132,13202,REGIÓN METROPOLITANA DE SANTIAGO,CORDILLERA,PIRQUE,8308,8296,12,26521,13429,13092,59.6,102.6,44.9,30.3,14.6
291,13,132,13203,REGIÓN METROPOLITANA DE SANTIAGO,CORDILLERA,SAN JOSÉ DE MAIPO,6926,6850,76,18189,9861,8328,3.7,118.4,40.6,25.1,15.5
59,13,133,13301,REGIÓN METROPOLITANA DE SANTIAGO,CHACABUCO,COLINA,43028,43000,28,146207,74635,71572,150.6,104.3,47.5,38.7,8.8
346,13,133,13302,REGIÓN METROPOLITANA DE SANTIAGO,CHACABUCO,LAMPA,33342,33316,26,102034,51545,50489,226.7,102.1,47.1,38.6,8.6
318,13,133,13303,REGIÓN METROPOLITANA DE SANTIAGO,CHACABUCO,TILTIL,6934,6900,34,19312,10047,9265,29.5,108.4,45.9,30.8,15.2
280,13,134,13401,REGIÓN METROPOLITANA DE SANTIAGO,MAIPO,SAN BERNARDO,90241,90193,48,301313,147800,153513,1970.9,96.3,45.7,33.1,12.6
14,13,134,13402,REGIÓN METROPOLITANA DE SANTIAGO,MAIPO,BUIN,31152,31109,43,96614,47575,49039,444.2,97,45.3,32.6,12.7
23,13,134,13403,REGIÓN METROPOLITANA DE SANTIAGO,MAIPO,CALERA DE TANGO,7601,7588,13,25392,12718,12674,347.2,100.3,43.6,30,13.5
197,13,134,13404,REGIÓN METROPOLITANA DE SANTIAGO,MAIPO,PAINE,24462,24431,31,72759,36521,36238,107.4,100.8,46.2,32,14.2
172,13,135,13501,REGIÓN METROPOLITANA DE SANTIAGO,MELIPILLA,MELIPILLA,43393,43329,64,123627,61410,62217,91.4,98.7,48.1,31,17.1
2,13,135,13502,REGIÓN METROPOLITANA DE SANTIAGO,MELIPILLA,ALHUÉ,2658,2627,31,6444,3516,2928,7.6,120.1,42.5,26.8,15.7
74,13,135,13503,REGIÓN METROPOLITANA DE SANTIAGO,MELIPILLA,CURACAVÍ,11806,11784,22,32579,16222,16357,46.9,99.2,48.2,30.6,17.6
166,13,135,13504,REGIÓN METROPOLITANA DE SANTIAGO,MELIPILLA,MARÍA PINTO,4852,4850,2,13590,6830,6760,34.4,101,47.1,30.2,16.9
296,13,135,13505,REGIÓN METROPOLITANA DE SANTIAGO,MELIPILLA,SAN PEDRO,4187,4184,3,9726,5132,4594,12.4,111.7,54.8,32.7,22.1
310,13,136,13601,REGIÓN METROPOLITANA DE SANTIAGO,TALAGANTE,TALAGANTE,23271,23251,20,74237,36769,37468,586.4,98.1,45.3,31.2,14.1
85,13,136,13602,REGIÓN METROPOLITANA DE SANTIAGO,TALAGANTE,EL MONTE,11869,11860,9,35923,17793,18130,312.7,98.1,48.6,33.5,15.1
114,13,136,13603,REGIÓN METROPOLITANA DE SANTIAGO,TALAGANTE,ISLA DE MAIPO,11826,11817,9,36219,18051,18168,191.3,99.4,47.5,32.4,15.1
193,13,136,13604,REGIÓN METROPOLITANA DE SANTIAGO,TALAGANTE,PADRE HURTADO,20807,20787,20,63250,31452,31798,780.2,98.9,45.6,32.7,12.9
211,13,136,13605,REGIÓN METROPOLITANA DE SANTIAGO,TALAGANTE,PEÑAFLOR,28549,28522,27,90201,43944,46257,1301,95,47.1,32.5,14.6
259,6,61,6101,REGIÓN DEL LIBERTADOR GENERAL BERNARDO O'HIGGINS,CACHAPOAL,RANCAGUA,90043,89904,139,241774,117942,123832,923.7,95.2,47.7,31.1,16.6
52,6,61,6102,REGIÓN DEL LIBERTADOR GENERAL BERNARDO O'HIGGINS,CACHAPOAL,CODEGUA,4402,4394,8,12988,6510,6478,45.5,100.5,46.4,31.1,15.3
56,6,61,6103,REGIÓN DEL LIBERTADOR GENERAL BERNARDO O'HIGGINS,CACHAPOAL,COINCO,2808,2804,4,7359,3729,3630,75.7,102.7,50.6,28.7,21.9
61,6,61,6104,REGIÓN DEL LIBERTADOR GENERAL BERNARDO O'HIGGINS,CACHAPOAL,COLTAUCO,7567,7562,5,19597,9806,9791,88.1,100.2,50.1,31.3,18.7
82,6,61,6105,REGIÓN DEL LIBERTADOR GENERAL BERNARDO O'HIGGINS,CACHAPOAL,DOÑIHUE,7738,7732,6,20887,10394,10493,260.6,99.1,49.3,32.2,17.1
101,6,61,6106,REGIÓN DEL LIBERTADOR GENERAL BERNARDO O'HIGGINS,CACHAPOAL,GRANEROS,11391,11379,12,33437,16634,16803,297.9,99,48.7,34.5,14.2
133,6,61,6107,REGIÓN DEL LIBERTADOR GENERAL BERNARDO O'HIGGINS,CACHAPOAL,LAS CABRAS,11894,11863,31,24640,12656,11984,32.8,105.6,48.5,29.5,19.1
159,6,61,6108,REGIÓN DEL LIBERTADOR GENERAL BERNARDO O'HIGGINS,CACHAPOAL,MACHALÍ,19701,19678,23,52505,25585,26920,20.2,95,48.9,36.7,12.3
163,6,61,6109,REGIÓN DEL LIBERTADOR GENERAL BERNARDO O'HIGGINS,CACHAPOAL,MALLOA,5023,5018,5,13407,6819,6588,60.9,103.5,48.3,28.2,20.1
175,6,61,6110,REGIÓN DEL LIBERTADOR GENERAL BERNARDO O'HIGGINS,CACHAPOAL,MOSTAZAL,9100,9090,10,25343,12663,12680,48.3,99.9,49,32.4,16.6
188,6,61,6111,REGIÓN DEL LIBERTADOR GENERAL BERNARDO O'HIGGINS,CACHAPOAL,OLIVAR,4636,4630,6,13608,6822,6786,287.6,100.5,46.5,31,15.5
216,6,61,6112,REGIÓN DEL LIBERTADOR GENERAL BERNARDO O'HIGGINS,CACHAPOAL,PEUMO,4931,4924,7,14313,7237,7076,92.2,102.3,47.9,29.1,18.9
218,6,61,6113,REGIÓN DEL LIBERTADOR GENERAL BERNARDO O'HIGGINS,CACHAPOAL,PICHIDEGUA,7287,7277,10,19714,10080,9634,61.8,104.6,48.8,28.6,20.2
255,6,61,6114,REGIÓN DEL LIBERTADOR GENERAL BERNARDO O'HIGGINS,CACHAPOAL,QUINTA DE TILCOCO,4740,4729,11,13002,6519,6483,149.9,100.6,47.5,28.6,18.9
265,6,61,6115,REGIÓN DEL LIBERTADOR GENERAL BERNARDO O'HIGGINS,CACHAPOAL,RENGO,20848,20827,21,58825,28844,29981,100.6,96.2,48.7,31.6,17
266,6,61,6116,REGIÓN DEL LIBERTADOR GENERAL BERNARDO O'HIGGINS,CACHAPOAL,REQUÍNOA,9236,9210,26,27968,14125,13843,41.5,102,46,31.7,14.3
302,6,61,6117,REGIÓN DEL LIBERTADOR GENERAL BERNARDO O'HIGGINS,CACHAPOAL,SAN VICENTE,17584,17564,20,46766,23302,23464,96.6,99.3,49.4,29.4,19.9
219,6,62,6201,REGIÓN DEL LIBERTADOR GENERAL BERNARDO O'HIGGINS,CARDENAL CARO,PICHILEMU,12056,12029,27,16394,8289,8105,22.9,102.3,47.6,27.9,19.7
119,6,62,6202,REGIÓN DEL LIBERTADOR GENERAL BERNARDO O'HIGGINS,CARDENAL CARO,LA ESTRELLA,1893,1891,2,3041,1603,1438,7,111.5,51.4,24.5,26.9
140,6,62,6203,REGIÓN DEL LIBERTADOR GENERAL BERNARDO O'HIGGINS,CARDENAL CARO,LITUECHE,3485,3476,9,6294,3287,3007,10.2,109.3,51.2,27.7,23.4
164,6,62,6204,REGIÓN DEL LIBERTADOR GENERAL BERNARDO O'HIGGINS,CARDENAL CARO,MARCHIHUE,3419,3411,8,7308,3745,3563,11.1,105.1,50.6,25.9,24.7
180,6,62,6205,REGIÓN DEL LIBERTADOR GENERAL BERNARDO O'HIGGINS,CARDENAL CARO,NAVIDAD,5525,5509,16,6641,3475,3166,22.2,109.8,59.7,25.7,34
203,6,62,6206,REGIÓN DEL LIBERTADOR GENERAL BERNARDO O'HIGGINS,CARDENAL CARO,PAREDONES,3852,3840,12,6188,3220,2968,10.8,108.5,53.5,24.3,29.3
286,6,63,6301,REGIÓN DEL LIBERTADOR GENERAL BERNARDO O'HIGGINS,COLCHAGUA,SAN FERNANDO,28736,28661,75,73973,36077,37896,31.9,95.2,49.4,31.9,17.5
40,6,63,6302,REGIÓN DEL LIBERTADOR GENERAL BERNARDO O'HIGGINS,COLCHAGUA,CHÉPICA,5740,5736,4,15037,7577,7460,31.5,101.6,50.4,28.6,21.8
45,6,63,6303,REGIÓN DEL LIBERTADOR GENERAL BERNARDO O'HIGGINS,COLCHAGUA,CHIMBARONGO,12923,12909,14,35399,17824,17575,69.6,101.4,47.7,30.1,17.6
146,6,63,6304,REGIÓN DEL LIBERTADOR GENERAL BERNARDO O'HIGGINS,COLCHAGUA,LOLOL,2982,2976,6,6811,3471,3340,11.4,103.9,52.9,26.4,26.5
178,6,63,6305,REGIÓN DEL LIBERTADOR GENERAL BERNARDO O'HIGGINS,COLCHAGUA,NANCAGUA,6546,6535,11,17833,8830,9003,117.6,98.1,48.3,29.8,18.5
199,6,63,6306,REGIÓN DEL LIBERTADOR GENERAL BERNARDO O'HIGGINS,COLCHAGUA,PALMILLA,4553,4549,4,12482,6331,6151,53.1,102.9,45.7,27.3,18.4
213,6,63,6307,REGIÓN DEL LIBERTADOR GENERAL BERNARDO O'HIGGINS,COLCHAGUA,PERALILLO,4490,4485,5,11007,5538,5469,39,101.3,49.1,27.3,21.8
223,6,63,6308,REGIÓN DEL LIBERTADOR GENERAL BERNARDO O'HIGGINS,COLCHAGUA,PLACILLA,3180,3174,6,8738,4432,4306,60.6,102.9,48.2,28.4,19.8
236,6,63,6309,REGIÓN DEL LIBERTADOR GENERAL BERNARDO O'HIGGINS,COLCHAGUA,PUMANQUE,1670,1668,2,3421,1751,1670,7.8,104.9,49.7,21.3,28.4
304,6,63,6310,REGIÓN DEL LIBERTADOR GENERAL BERNARDO O'HIGGINS,COLCHAGUA,SANTA CRUZ,14334,14300,34,37855,18593,19262,96.1,96.5,48.5,29.5,19
311,7,71,7101,REGIÓN DEL MAULE,TALCA,TALCA,80810,80575,235,220357,105622,114735,949.8,92.1,45.2,27.9,17.3
66,7,71,7102,REGIÓN DEL MAULE,TALCA,CONSTITUCIÓN,18740,18660,80,46068,23005,23063,34.5,99.7,47.5,32.5,14.9
78,7,71,7103,REGIÓN DEL MAULE,TALCA,CUREPTO,4556,4550,6,9448,4852,4596,8.8,105.6,56,24.1,31.9
88,7,71,7104,REGIÓN DEL MAULE,TALCA,EMPEDRADO,1660,1652,8,4142,2199,1943,7.3,113.2,48.8,29.9,18.9
168,7,71,7105,REGIÓN DEL MAULE,TALCA,MAULE,18683,18670,13,49721,24259,25462,204.6,95.3,48.7,38.6,10.1
206,7,71,7106,REGIÓN DEL MAULE,TALCA,PELARCO,3282,3278,4,8422,4231,4191,25.5,101,51.8,29.7,22.1
209,7,71,7107,REGIÓN DEL MAULE,TALCA,PENCAHUE,3555,3551,4,8245,4242,4003,8.6,106,49.9,26.7,23.2
270,7,71,7108,REGIÓN DEL MAULE,TALCA,RÍO CLARO,5506,5500,6,13906,7246,6660,32.1,108.8,47.5,28.2,19.3
282,7,71,7109,REGIÓN DEL MAULE,TALCA,SAN CLEMENTE,18387,18348,39,43269,21677,21592,9.6,100.4,49.8,31.3,18.5
299,7,71,7110,REGIÓN DEL MAULE,TALCA,SAN RAFAEL,3593,3590,3,9191,4569,4622,34.9,98.9,52.3,33.2,19.1
34,7,72,7201,REGIÓN DEL MAULE,CAUQUENES,CAUQUENES,17895,17878,17,40441,19314,21127,19,91.4,56.7,31,25.7
38,7,72,7202,REGIÓN DEL MAULE,CAUQUENES,CHANCO,3704,3697,7,8928,4450,4478,16.9,99.4,54.2,30.1,24.1
207,7,72,7203,REGIÓN DEL MAULE,CAUQUENES,PELLUHUE,5791,5758,33,7571,3765,3806,20.5,98.9,58.2,31.6,26.5
79,7,73,7301,REGIÓN DEL MAULE,CURICÓ,CURICÓ,54598,54549,49,149136,72511,76625,111.9,94.6,46.1,30.2,15.8
105,7,73,7302,REGIÓN DEL MAULE,CURICÓ,HUALAÑÉ,4329,4322,7,9657,4883,4774,15.3,102.3,52.9,27.6,25.4
137,7,73,7303,REGIÓN DEL MAULE,CURICÓ,LICANTÉN,3959,3931,28,6653,3353,3300,24.5,101.6,49.8,27.7,22.2
173,7,73,7304,REGIÓN DEL MAULE,CURICÓ,MOLINA,17338,17305,33,45976,22635,23341,30.3,97,48.3,30.4,17.9
261,7,73,7305,REGIÓN DEL MAULE,CURICÓ,RAUCO,4158,4156,2,10484,5238,5246,33.9,99.8,49.6,29.4,20.2
275,7,73,7306,REGIÓN DEL MAULE,CURICÓ,ROMERAL,5709,5684,25,15187,7624,7563,9.5,100.8,45.8,29.1,16.7
277,7,73,7307,REGIÓN DEL MAULE,CURICÓ,SAGRADA FAMILIA,6842,6837,5,18544,9384,9160,33.8,102.4,45.9,27.9,18.1
315,7,73,7308,REGIÓN DEL MAULE,CURICÓ,TENO,10807,10789,18,28921,14764,14157,46.7,104.3,46.6,28.8,17.8
332,7,73,7309,REGIÓN DEL MAULE,CURICÓ,VICHUQUÉN,3465,3453,12,4322,2217,2105,9.6,105.3,52,26.1,25.8
139,7,74,7401,REGIÓN DEL MAULE,LINARES,LINARES,35676,35641,35,93602,44671,48931,63.8,91.3,50.1,31.3,18.8
57,7,74,7402,REGIÓN DEL MAULE,LINARES,COLBÚN,9021,8995,26,20765,10205,10560,7.1,96.6,52.5,32,20.4
148,7,74,7403,REGIÓN DEL MAULE,LINARES,LONGAVÍ,11888,11881,7,30534,15482,15052,21,102.9,48.9,29.5,19.4
204,7,74,7404,REGIÓN DEL MAULE,LINARES,PARRAL,17448,17427,21,41637,20165,21472,25.4,93.9,53.8,32.4,21.4
267,7,74,7405,REGIÓN DEL MAULE,LINARES,RETIRO,8260,8251,9,19974,10054,9920,24.2,101.4,50.9,30.1,20.9
289,7,74,7406,REGIÓN DEL MAULE,LINARES,SAN JAVIER,17895,17869,26,45547,22002,23545,34.7,93.4,51.7,31.7,19.9
336,7,74,7407,REGIÓN DEL MAULE,LINARES,VILLA ALEGRE,6833,6826,7,16221,7880,8341,85.4,94.5,53.4,30.8,22.6
341,7,74,7408,REGIÓN DEL MAULE,LINARES,YERBAS BUENAS,6813,6811,2,18081,9125,8956,69.6,101.9,49.6,31.4,18.2
43,16,161,16101,REGIÓN DEL ÑUBLE,DIGUILLÍN,CHILLÁN,67854,67744,110,184739,87521,97218,388.9,90,46.7,28.9,17.8
15,16,161,16102,REGIÓN DEL ÑUBLE,DIGUILLÍN,BULNES,8751,8742,9,21493,10382,11111,50.3,93.4,51.1,29.9,21.3
44,16,161,16103,REGIÓN DEL ÑUBLE,DIGUILLÍN,CHILLÁN VIEJO,11276,11267,9,30907,14581,16326,117.2,89.3,46.9,33,13.9
84,16,161,16104,REGIÓN DEL ÑUBLE,DIGUILLÍN,EL CARMEN,4913,4909,4,12044,5967,6077,18.1,98.2,53.3,29,24.3
208,16,161,16105,REGIÓN DEL ÑUBLE,DIGUILLÍN,PEMUCO,3430,3425,5,8448,4221,4227,15,99.9,50.4,29.5,20.9
220,16,161,16106,REGIÓN DEL ÑUBLE,DIGUILLÍN,PINTO,5429,5414,15,10827,5336,5491,9.8,97.2,49.2,27.1,22.1
251,16,161,16107,REGIÓN DEL ÑUBLE,DIGUILLÍN,QUILLÓN,10739,10734,5,17485,8664,8821,43,98.2,54.2,27.8,26.3
288,16,161,16108,REGIÓN DEL ÑUBLE,DIGUILLÍN,SAN IGNACIO,6651,6647,4,16079,7882,8197,44.4,96.2,50.7,28.4,22.3
343,16,161,16109,REGIÓN DEL ÑUBLE,DIGUILLÍN,YUNGAY,8284,8265,19,17787,8964,8823,21.6,101.6,51.4,29.3,22.1
258,16,162,16201,REGIÓN DEL ÑUBLE,ITATA,QUIRIHUE,5248,5234,14,11594,5679,5915,19.8,96,53.2,28.9,24.3
49,16,162,16202,REGIÓN DEL ÑUBLE,ITATA,COBQUECURA,3213,3199,14,5012,2525,2487,8.7,101.5,53.9,22.7,31.2
53,16,162,16203,REGIÓN DEL ÑUBLE,ITATA,COELEMU,6140,6128,12,15995,7873,8122,46.5,96.9,53.1,30.5,22.5
182,16,162,16204,REGIÓN DEL ÑUBLE,ITATA,NINHUE,2299,2297,2,5213,2567,2646,12.9,97,55,25.7,29.3
224,16,162,16205,REGIÓN DEL ÑUBLE,ITATA,PORTEZUELO,2070,2067,3,4862,2416,2446,16.8,98.8,54.1,27.3,26.8
260,16,162,16206,REGIÓN DEL ÑUBLE,ITATA,RÁNQUIL,2826,2821,5,5755,2842,2913,23.1,97.6,58.3,28,30.3
327,16,162,16207,REGIÓN DEL ÑUBLE,ITATA,TREGUACO,2524,2522,2,5401,2703,2698,17.2,100.2,52.7,27.8,24.9
281,16,163,16301,REGIÓN DEL ÑUBLE,PUNILLA,SAN CARLOS,20980,20963,17,53024,25425,27599,60.5,92.1,51,29.5,21.5
55,16,163,16302,REGIÓN DEL ÑUBLE,PUNILLA,COIHUECO,10054,10048,6,26881,13424,13457,15.2,99.8,47.8,30.9,16.9
185,16,163,16303,REGIÓN DEL ÑUBLE,PUNILLA,ÑIQUÉN,4842,4837,5,11152,5616,5536,22.6,101.4,56.1,28.1,28.1
284,16,163,16304,REGIÓN DEL ÑUBLE,PUNILLA,SAN FABIÁN,2306,2298,8,4308,2203,2105,2.8,104.7,55.4,28.8,26.6
294,16,163,16305,REGIÓN DEL ÑUBLE,PUNILLA,SAN NICOLÁS,4727,4725,2,11603,5796,5807,20.5,99.8,49.6,27.8,21.8
64,8,81,8101,REGIÓN DEL BIOBÍO,CONCEPCIÓN,CONCEPCIÓN,85638,85352,286,223574,107624,115950,1033.6,92.8,39.2,21.8,17.3
70,8,81,8102,REGIÓN DEL BIOBÍO,CONCEPCIÓN,CORONEL,41175,41144,31,116262,55799,60463,424.9,92.3,47.6,33.2,14.4
41,8,81,8103,REGIÓN DEL BIOBÍO,CONCEPCIÓN,CHIGUAYANTE,28959,28943,16,85938,40505,45433,1354.6,89.2,44.6,28.3,16.3
91,8,81,8104,REGIÓN DEL BIOBÍO,CONCEPCIÓN,FLORIDA,5172,5164,8,10624,5386,5238,17.5,102.8,51.5,25.9,25.6
107,8,81,8105,REGIÓN DEL BIOBÍO,CONCEPCIÓN,HUALQUI,9031,9012,19,24333,11843,12490,45.5,94.8,49.2,32.6,16.6
157,8,81,8106,REGIÓN DEL BIOBÍO,CONCEPCIÓN,LOTA,15489,15486,3,43535,20950,22585,378.5,92.8,48.9,30,18.9
210,8,81,8107,REGIÓN DEL BIOBÍO,CONCEPCIÓN,PENCO,15834,15824,10,47367,22617,24750,440,91.4,47.1,29.6,17.6
298,8,81,8108,REGIÓN DEL BIOBÍO,CONCEPCIÓN,SAN PEDRO DE LA PAZ,47511,47489,22,131808,62941,68867,1435.3,91.4,46.4,33.6,12.8
305,8,81,8109,REGIÓN DEL BIOBÍO,CONCEPCIÓN,SANTA JUANA,6219,6211,8,13749,6751,6998,17.6,96.5,53.9,31.3,22.6
312,8,81,8110,REGIÓN DEL BIOBÍO,CONCEPCIÓN,TALCAHUANO,50599,50550,49,151749,72993,78756,1624.6,92.7,45,27.5,17.5
323,8,81,8111,REGIÓN DEL BIOBÍO,CONCEPCIÓN,TOMÉ,23323,23311,12,54946,25919,29027,110.6,89.3,50.5,28.9,21.6
106,8,81,8112,REGIÓN DEL BIOBÍO,CONCEPCIÓN,HUALPÉN,30722,30704,18,91773,43488,48285,2008.7,90.1,46.2,27.9,18.3
136,8,82,8201,REGIÓN DEL BIOBÍO,ARAUCO,LEBU,9288,9262,26,25522,12441,13081,45.4,95.1,50,33.6,16.4
11,8,82,8202,REGIÓN DEL BIOBÍO,ARAUCO,ARAUCO,13252,13211,41,36257,17875,18382,37.8,97.2,48,31.7,16.3
28,8,82,8203,REGIÓN DEL BIOBÍO,ARAUCO,CAÑETE,12855,12835,20,34537,16641,17896,31.7,93,54.5,36,18.5
67,8,82,8204,REGIÓN DEL BIOBÍO,ARAUCO,CONTULMO,2694,2687,7,6031,3028,3003,9.4,100.8,53.6,31.5,22.1
76,8,82,8205,REGIÓN DEL BIOBÍO,ARAUCO,CURANILAHUE,11301,11290,11,32288,15828,16460,32.1,96.2,49.1,32.2,16.9
150,8,82,8206,REGIÓN DEL BIOBÍO,ARAUCO,LOS ÁLAMOS,7721,7711,10,21035,10203,10832,34.9,94.2,53.5,37.4,16.1
320,8,82,8207,REGIÓN DEL BIOBÍO,ARAUCO,TIRÚA,4052,4041,11,10417,5195,5222,16.6,99.5,51.5,37,14.6
152,8,83,8301,REGIÓN DEL BIOBÍO,BIOBÍO,LOS ÁNGELES,74936,74832,104,202331,97980,104351,115.5,93.9,48.9,32.7,16.2
10,8,83,8302,REGIÓN DEL BIOBÍO,BIOBÍO,ANTUCO,2008,1996,12,4073,1975,2098,2.1,94.1,56.4,31.1,25.2
18,8,83,8303,REGIÓN DEL BIOBÍO,BIOBÍO,CABRERO,11048,11028,20,28573,14174,14399,43.4,98.4,48.4,30.5,17.9
131,8,83,8304,REGIÓN DEL BIOBÍO,BIOBÍO,LAJA,8747,8734,13,22389,10744,11645,65.1,92.3,53.8,33.1,20.7
176,8,83,8305,REGIÓN DEL BIOBÍO,BIOBÍO,MULCHÉN,10689,10665,24,29627,14597,15030,15.4,97.1,52.6,32.7,19.9
177,8,83,8306,REGIÓN DEL BIOBÍO,BIOBÍO,NACIMIENTO,10130,10107,23,26315,12962,13353,29,97.1,51,32.9,18.1
181,8,83,8307,REGIÓN DEL BIOBÍO,BIOBÍO,NEGRETE,3521,3518,3,9737,4813,4924,62.6,97.7,53.1,33.6,19.5
248,8,83,8308,REGIÓN DEL BIOBÍO,BIOBÍO,QUILACO,1936,1931,5,3988,2001,1987,3.5,100.7,61.5,29,32.4
250,8,83,8309,REGIÓN DEL BIOBÍO,BIOBÍO,QUILLECO,3880,3875,5,9587,4720,4867,8.5,97,57.5,30.2,27.3
301,8,83,8310,REGIÓN DEL BIOBÍO,BIOBÍO,SAN ROSENDO,1500,1497,3,3412,1661,1751,36.9,94.9,57.3,31.4,26
303,8,83,8311,REGIÓN DEL BIOBÍO,BIOBÍO,SANTA BÁRBARA,5447,5432,15,13773,6699,7074,11,94.7,55.6,33.9,21.7
328,8,83,8312,REGIÓN DEL BIOBÍO,BIOBÍO,TUCAPEL,6510,6500,10,14134,6876,7258,15.5,94.7,56.3,31.9,24.4
342,8,83,8313,REGIÓN DEL BIOBÍO,BIOBÍO,YUMBEL,10248,10234,14,21198,10465,10733,29.1,97.5,53.6,27.6,26
3,8,83,8314,REGIÓN DEL BIOBÍO,BIOBÍO,ALTO BIOBÍO,2137,2107,30,5923,3036,2887,2.8,105.2,57.6,45.5,12.1
314,9,91,9101,REGIÓN DE LA ARAUCANÍA,CAUTÍN,TEMUCO,104757,104553,204,282415,134289,148126,606.2,90.7,43.8,28.2,15.5
29,9,91,9102,REGIÓN DE LA ARAUCANÍA,CAUTÍN,CARAHUE,9598,9582,16,24533,12202,12331,18.3,99,58.3,35,23.2
72,9,91,9103,REGIÓN DE LA ARAUCANÍA,CAUTÍN,CUNCO,8036,8024,12,17526,8765,8761,9.3,100,58.9,31.2,27.7
77,9,91,9104,REGIÓN DE LA ARAUCANÍA,CAUTÍN,CURARREHUE,3281,3269,12,7489,3821,3668,6.4,104.2,56.1,36.4,19.7
92,9,91,9105,REGIÓN DE LA ARAUCANÍA,CAUTÍN,FREIRE,9293,9284,9,24606,12413,12193,28.1,101.8,51.8,30.4,21.4
98,9,91,9106,REGIÓN DE LA ARAUCANÍA,CAUTÍN,GALVARINO,4275,4271,4,11996,6032,5964,21.1,101.1,59.1,36,23.1
100,9,91,9107,REGIÓN DE LA ARAUCANÍA,CAUTÍN,GORBEA,6119,6111,8,14414,6945,7469,20.8,93,53.9,28.1,25.8
135,9,91,9108,REGIÓN DE LA ARAUCANÍA,CAUTÍN,LAUTARO,14125,14106,19,38013,18448,19565,41.9,94.3,51.3,33.6,17.7
147,9,91,9109,REGIÓN DE LA ARAUCANÍA,CAUTÍN,LONCOCHE,10069,10061,8,23612,11502,12110,24.2,95,56.6,33.3,23.3
171,9,91,9110,REGIÓN DE LA ARAUCANÍA,CAUTÍN,MELIPEUCO,2742,2724,18,6138,3091,3047,5.5,101.4,59.8,31.8,28
184,9,91,9111,REGIÓN DE LA ARAUCANÍA,CAUTÍN,NUEVA IMPERIAL,12130,12112,18,32510,15870,16640,44.5,95.4,55.9,33.9,22.1
194,9,91,9112,REGIÓN DE LA ARAUCANÍA,CAUTÍN,PADRE LAS CASAS,26158,26141,17,76126,36996,39130,164.1,94.5,48.3,33.9,14.4
214,9,91,9113,REGIÓN DE LA ARAUCANÍA,CAUTÍN,PERQUENCO,2877,2876,1,6905,3395,3510,20.8,96.7,53.5,33.2,20.4
222,9,91,9114,REGIÓN DE LA ARAUCANÍA,CAUTÍN,PITRUFQUÉN,10168,10147,21,24837,12065,12772,43,94.5,53.2,30.3,22.9
230,9,91,9115,REGIÓN DE LA ARAUCANÍA,CAUTÍN,PUCÓN,17356,17242,114,28523,14106,14417,22.8,97.8,46.9,30.9,16
276,9,91,9116,REGIÓN DE LA ARAUCANÍA,CAUTÍN,SAAVEDRA,5686,5672,14,12450,6129,6321,31.8,97,61.6,35.1,26.5
316,9,91,9117,REGIÓN DE LA ARAUCANÍA,CAUTÍN,TEODORO SCHMIDT,6442,6438,4,15045,7526,7519,23,100.1,58.9,32.3,26.5
322,9,91,9118,REGIÓN DE LA ARAUCANÍA,CAUTÍN,TOLTÉN,4153,4145,8,9722,4883,4839,11.4,100.9,56.4,31.7,24.7
335,9,91,9119,REGIÓN DE LA ARAUCANÍA,CAUTÍN,VILCÚN,11112,11101,11,28151,13873,14278,19.9,97.2,51.5,34.1,17.4
338,9,91,9120,REGIÓN DE LA ARAUCANÍA,CAUTÍN,VILLARRICA,28288,28215,73,55478,27196,28282,42.9,96.2,50.1,31.9,18.2
46,9,91,9121,REGIÓN DE LA ARAUCANÍA,CAUTÍN,CHOLCHOL,4213,4200,13,11611,5773,5838,27,98.9,59,36.5,22.5
8,9,92,9201,REGIÓN DE LA ARAUCANÍA,MALLECO,ANGOL,19413,19366,47,53262,25613,27649,44.5,92.6,51.9,32.5,19.4
60,9,92,9202,REGIÓN DE LA ARAUCANÍA,MALLECO,COLLIPULLI,9341,9322,19,24598,12064,12534,18.8,96.3,53.9,35.1,18.8
73,9,92,9203,REGIÓN DE LA ARAUCANÍA,MALLECO,CURACAUTÍN,8182,8166,16,17413,8376,9037,10.5,92.7,56.8,31.5,25.3
89,9,92,9204,REGIÓN DE LA ARAUCANÍA,MALLECO,ERCILLA,2821,2818,3,7733,3817,3916,15.5,97.5,59,36.9,22
149,9,92,9205,REGIÓN DE LA ARAUCANÍA,MALLECO,LONQUIMAY,4790,4771,19,10251,5346,4905,2.6,109,52.2,33.2,19
155,9,92,9206,REGIÓN DE LA ARAUCANÍA,MALLECO,LOS SAUCES,3051,3043,8,7265,3607,3658,8.5,98.6,53.6,30,23.6
158,9,92,9207,REGIÓN DE LA ARAUCANÍA,MALLECO,LUMACO,3854,3847,7,9548,4927,4621,8.6,106.6,58.1,34.8,23.3
240,9,92,9208,REGIÓN DE LA ARAUCANÍA,MALLECO,PURÉN,4809,4800,9,11779,5677,6102,25.3,93,57.3,34,23.3
263,9,92,9209,REGIÓN DE LA ARAUCANÍA,MALLECO,RENAICO,3928,3924,4,10250,4957,5293,38.6,93.7,50.6,32.1,18.5
326,9,92,9210,REGIÓN DE LA ARAUCANÍA,MALLECO,TRAIGUÉN,7256,7242,14,18843,9019,9824,21,91.8,56.7,32.4,24.3
333,9,92,9211,REGIÓN DE LA ARAUCANÍA,MALLECO,VICTORIA,12828,12800,28,34182,16408,17774,27.1,92.3,50.9,29.9,21
329,14,141,14101,REGIÓN DE LOS RÍOS,VALDIVIA,VALDIVIA,61192,60955,237,166080,80348,85732,171.5,93.7,42.8,26.6,16.2
71,14,141,14102,REGIÓN DE LOS RÍOS,VALDIVIA,CORRAL,2574,2563,11,5302,2635,2667,7.3,98.8,52.6,28.8,23.8
132,14,141,14103,REGIÓN DE LOS RÍOS,VALDIVIA,LANCO,6450,6433,17,16752,8224,8528,31.5,96.4,54,33.6,20.4
153,14,141,14104,REGIÓN DE LOS RÍOS,VALDIVIA,LOS LAGOS,7913,7890,23,19634,9757,9877,11,98.8,51.4,31.9,19.5
161,14,141,14105,REGIÓN DE LOS RÍOS,VALDIVIA,MÁFIL,2712,2707,5,7095,3492,3603,12.3,96.9,55.3,33.5,21.8
167,14,141,14106,REGIÓN DE LOS RÍOS,VALDIVIA,MARIQUINA,8417,8405,12,21278,10607,10671,16.4,99.4,55.4,36.5,18.8
196,14,141,14107,REGIÓN DE LOS RÍOS,VALDIVIA,PAILLACO,7626,7603,23,20188,10067,10121,22.4,99.5,51.9,31.6,20.3
200,14,141,14108,REGIÓN DE LOS RÍOS,VALDIVIA,PANGUIPULLI,16810,16752,58,34539,17199,17340,10.5,99.2,51.9,32.4,19.5
127,14,142,14201,REGIÓN DE LOS RÍOS,RANCO,LA UNIÓN,15125,15088,37,38036,18729,19307,17.8,97,52.8,31.2,21.6
97,14,142,14202,REGIÓN DE LOS RÍOS,RANCO,FUTRONO,6500,6482,18,14665,7252,7413,7,97.8,53.4,34.5,18.9
128,14,142,14203,REGIÓN DE LOS RÍOS,RANCO,LAGO RANCO,5345,5335,10,9896,5045,4851,5.7,104,54.8,31.7,23
269,14,142,14204,REGIÓN DE LOS RÍOS,RANCO,RÍO BUENO,13312,13296,16,31372,15492,15880,14.4,97.6,52.5,29.7,22.8
233,10,101,10101,REGIÓN DE LOS LAGOS,LLANQUIHUE,PUERTO MONTT,93380,93172,208,245902,121019,124883,146.7,96.9,43.4,31.2,12.2
20,10,101,10102,REGIÓN DE LOS LAGOS,LLANQUIHUE,CALBUCO,13570,13534,36,33985,17104,16881,57.7,101.3,51.7,32.3,19.4
50,10,101,10103,REGIÓN DE LOS LAGOS,LLANQUIHUE,COCHAMÓ,2240,2220,20,4023,2195,1828,1,120.1,48.7,24.8,23.9
94,10,101,10104,REGIÓN DE LOS LAGOS,LLANQUIHUE,FRESIA,5262,5254,8,12261,6181,6080,9.6,101.7,51.1,28.5,22.6
95,10,101,10105,REGIÓN DE LOS LAGOS,LLANQUIHUE,FRUTILLAR,7909,7885,24,18428,9093,9335,22.2,97.4,48.2,30.6,17.6
154,10,101,10106,REGIÓN DE LOS LAGOS,LLANQUIHUE,LOS MUERMOS,7264,7257,7,17068,8681,8387,13.9,103.5,53.1,30.4,22.7
141,10,101,10107,REGIÓN DE LOS LAGOS,LLANQUIHUE,LLANQUIHUE,6135,6123,12,17591,8627,8964,40.5,96.2,47.1,29.9,17.2
169,10,101,10108,REGIÓN DE LOS LAGOS,LLANQUIHUE,MAULLÍN,6630,6616,14,14216,7231,6985,17.6,103.5,53,27.8,25.2
235,10,101,10109,REGIÓN DE LOS LAGOS,LLANQUIHUE,PUERTO VARAS,17643,17541,102,44578,21878,22700,11.1,96.4,46.6,32.3,14.3
32,10,102,10201,REGIÓN DE LOS LAGOS,CHILOÉ,CASTRO,18021,17929,92,43807,21471,22336,93.4,96.1,46.5,30.5,16
6,10,102,10202,REGIÓN DE LOS LAGOS,CHILOÉ,ANCUD,16959,16925,34,38991,19029,19962,22.3,95.3,49.9,29.9,20
47,10,102,10203,REGIÓN DE LOS LAGOS,CHILOÉ,CHONCHI,6706,6689,17,14858,7445,7413,10.8,100.4,45.3,28.7,16.6
75,10,102,10204,REGIÓN DE LOS LAGOS,CHILOÉ,CURACO DE VÉLEZ,1693,1687,6,3829,1853,1976,48.1,93.8,56.3,32.3,24
80,10,102,10205,REGIÓN DE LOS LAGOS,CHILOÉ,DALCAHUE,5659,5615,44,13762,6913,6849,11.2,100.9,49,32,17
239,10,102,10206,REGIÓN DE LOS LAGOS,CHILOÉ,PUQUELDÓN,1641,1623,18,3921,1973,1948,40.8,101.3,52.6,27.4,25.2
245,10,102,10207,REGIÓN DE LOS LAGOS,CHILOÉ,QUEILÉN,2450,2431,19,5385,2773,2612,16.3,106.2,49.8,30.2,19.6
246,10,102,10208,REGIÓN DE LOS LAGOS,CHILOÉ,QUELLÓN,11003,10946,57,27192,13857,13335,8.1,103.9,43.9,33.5,10.4
247,10,102,10209,REGIÓN DE LOS LAGOS,CHILOÉ,QUEMCHI,3860,3832,28,8352,4308,4044,18.9,106.5,52.9,29.2,23.7
254,10,102,10210,REGIÓN DE LOS LAGOS,CHILOÉ,QUINCHAO,3566,3530,36,8088,3941,4147,51.2,95,53.1,30.1,23.1
191,10,103,10301,REGIÓN DE LOS LAGOS,OSORNO,OSORNO,60132,60059,73,161460,77155,84305,168.7,91.5,47.1,29.8,17.2
234,10,103,10302,REGIÓN DE LOS LAGOS,OSORNO,PUERTO OCTAY,4099,4081,18,8999,4721,4278,5,110.4,47.1,28.6,18.5
241,10,103,10303,REGIÓN DE LOS LAGOS,OSORNO,PURRANQUE,7873,7857,16,20369,9976,10393,14,96,53.7,30.8,22.9
244,10,103,10304,REGIÓN DE LOS LAGOS,OSORNO,PUYEHUE,4911,4893,18,11667,5958,5709,7.1,104.4,49.2,28.5,20.7
273,10,103,10305,REGIÓN DE LOS LAGOS,OSORNO,RÍO NEGRO,5670,5662,8,14085,7051,7034,11.1,100.2,53.3,29.8,23.5
292,10,103,10306,REGIÓN DE LOS LAGOS,OSORNO,SAN JUAN DE LA COSTA,5314,5309,5,7512,4011,3501,4.9,114.6,55.8,27.3,28.4
295,10,103,10307,REGIÓN DE LOS LAGOS,OSORNO,SAN PABLO,4235,4229,6,10030,4978,5052,15.9,98.5,54.4,29,25.4
37,10,104,10401,REGIÓN DE LOS LAGOS,PALENA,CHAITÉN,2221,2161,60,5071,3016,2055,0.6,146.8,37.5,23.9,13.6
96,10,104,10402,REGIÓN DE LOS LAGOS,PALENA,FUTALEUFÚ,1433,1409,24,2623,1375,1248,2.1,110.2,43.6,26.2,17.4
104,10,104,10403,REGIÓN DE LOS LAGOS,PALENA,HUALAIHUÉ,4439,4418,21,8944,4701,4243,3.1,110.8,49.9,33.4,16.5
198,10,104,10404,REGIÓN DE LOS LAGOS,PALENA,PALENA,1002,999,3,1711,886,825,0.6,107.4,49.2,26.2,23
54,11,111,11101,REGIÓN DE AYSÉN DEL GENERAL CARLOS IBÁÑEZ DEL CAMPO,COYHAIQUE,COYHAIQUE,23999,23863,136,57818,28763,29055,7.9,99,47.5,34.4,13.1
129,11,111,11102,REGIÓN DE AYSÉN DEL GENERAL CARLOS IBÁÑEZ DEL CAMPO,COYHAIQUE,LAGO VERDE,606,592,14,852,494,358,0.2,138,46.6,26.2,20.5
13,11,112,11201,REGIÓN DE AYSÉN DEL GENERAL CARLOS IBÁÑEZ DEL CAMPO,AYSÉN,AYSÉN,9617,9496,121,23959,12719,11240,0.8,113.2,46.9,34.2,12.6
48,11,112,11202,REGIÓN DE AYSÉN DEL GENERAL CARLOS IBÁÑEZ DEL CAMPO,AYSÉN,CISNES,2940,2806,134,6517,3922,2595,0.4,151.1,35.4,25.6,9.8
102,11,112,11203,REGIÓN DE AYSÉN DEL GENERAL CARLOS IBÁÑEZ DEL CAMPO,AYSÉN,GUAITECAS,690,677,13,1843,1166,677,2.9,172.2,32.4,23.8,8.6
51,11,113,11301,REGIÓN DE AYSÉN DEL GENERAL CARLOS IBÁÑEZ DEL CAMPO,CAPITÁN PRAT,COCHRANE,1771,1726,45,3490,1902,1588,0.4,119.8,43.4,29.9,13.5
187,11,113,11302,REGIÓN DE AYSÉN DEL GENERAL CARLOS IBÁÑEZ DEL CAMPO,CAPITÁN PRAT,O'HIGGINS,363,345,18,625,374,251,0.1,149,39.8,30.2,9.6
325,11,113,11303,REGIÓN DE AYSÉN DEL GENERAL CARLOS IBÁÑEZ DEL CAMPO,CAPITÁN PRAT,TORTEL,320,303,17,523,285,238,0,119.7,43.3,33.7,9.6
42,11,114,11401,REGIÓN DE AYSÉN DEL GENERAL CARLOS IBÁÑEZ DEL CAMPO,GENERAL CARRERA,CHILE CHICO,2602,2560,42,4865,2577,2288,0.8,112.6,46.1,29.1,17
272,11,114,11402,REGIÓN DE AYSÉN DEL GENERAL CARLOS IBÁÑEZ DEL CAMPO,GENERAL CARRERA,RÍO IBÁÑEZ,1813,1785,28,2666,1445,1221,0.4,118.3,49,26.6,22.5
238,12,121,12101,REGIÓN DE MAGALLANES Y DE LA ANTÁRTICA CHILENA,MAGALLANES,PUNTA ARENAS,50501,50297,204,131592,65538,66054,7.4,99.2,44.3,27.2,17.1
130,12,121,12102,REGIÓN DE MAGALLANES Y DE LA ANTÁRTICA CHILENA,MAGALLANES,LAGUNA BLANCA,285,274,11,274,191,83,0.1,230.1,38.4,23.7,14.6
274,12,121,12103,REGIÓN DE MAGALLANES Y DE LA ANTÁRTICA CHILENA,MAGALLANES,RÍO VERDE,231,204,27,617,522,95,0.1,549.5,8.1,2.3,5.8
287,12,121,12104,REGIÓN DE MAGALLANES Y DE LA ANTÁRTICA CHILENA,MAGALLANES,SAN GREGORIO,372,344,28,799,619,180,0.1,343.9,17.5,10,7.5
17,12,122,12201,REGIÓN DE MAGALLANES Y DE LA ANTÁRTICA CHILENA,ANTÁRTICA CHILENA,CABO DE HORNOS,762,716,46,2063,1195,868,0.1,137.7,39.3,34.9,4.4
225,12,123,12301,REGIÓN DE MAGALLANES Y DE LA ANTÁRTICA CHILENA,TIERRA DEL FUEGO,PORVENIR,3187,3127,60,6801,3993,2808,0.9,142.2,39.2,25.7,13.5
227,12,123,12302,REGIÓN DE MAGALLANES Y DE LA ANTÁRTICA CHILENA,TIERRA DEL FUEGO,PRIMAVERA,472,399,73,1158,930,228,0.3,407.9,14.3,9.2,5.1
319,12,123,12303,REGIÓN DE MAGALLANES Y DE LA ANTÁRTICA CHILENA,TIERRA DEL FUEGO,TIMAUKEL,214,206,8,405,343,62,0,553.2,15.1,8,7.1
179,12,124,12401,REGIÓN DE MAGALLANES Y DE LA ANTÁRTICA CHILENA,ÚLTIMA ESPERANZA,NATALES,9369,9259,110,21477,10992,10485,0.4,104.8,46.7,27.8,18.8
324,12,124,12402,REGIÓN DE MAGALLANES Y DE LA ANTÁRTICA CHILENA,ÚLTIMA ESPERANZA,TORRES DEL PAINE,226,188,38,1209,800,409,0.2,195.6,11.8,4.4,7.4
